1	1	1	1	1
1	p	b		1
1	1	1	c	1
1	e			1
1	1	1	1	1